..********
*.*......*
*.*.****.*
*.*.*..*.*
*.*.*T.*.*
*.*.**.*.*
*.*....*.*
*.******.*
*........*
**********



..********
*.*......*
***.****.*
*.*.*..*.*
*.*.*T.*.*
*.*.**.*.*
*.*....*.*
*.******.*
*........*
**********